malignant neoplasm of posterior wall of urinary bladder	is a	cancer
malignant neoplasm of posterior wall of urinary bladder	may spread to	lymph nodes
cystoscopy	is a	procedure to diagnose	malignant neoplasm of posterior wall of urinary bladder
hematuria	is a symptom of	malignant neoplasm of posterior wall of urinary bladder
malignant neoplasm of posterior wall of urinary bladder	is treated with	surgery
radical cystectomy	is a	surgical procedure for	malignant neoplasm of posterior wall of urinary bladder
chemotherapy	is a	treatment option for	malignant neoplasm of posterior wall of urinary bladder
cisplatin	is a	chemotherapy drug used for	malignant neoplasm of posterior wall of urinary bladder
radiation therapy	is a	treatment option for	malignant neoplasm of posterior wall of urinary bladder
brachytherapy	is a	form of radiation therapy for	malignant neoplasm of posterior wall of urinary bladder
bladder reconstruction	is a	surgical procedure after	removal of malignant neoplasm of posterior wall of urinary bladder
urinary diversion	is a	procedure to divert urine after	bladder reconstruction
urothelial carcinoma	is commonly associated with	malignant neoplasm of posterior wall of urinary bladder
smoking	is a	risk factor for	malignant neoplasm of posterior wall of urinary bladder
pathology report	provides	information about the stage and grade of	malignant neoplasm of posterior wall of urinary bladder
TNM staging system	is used to stage	malignant neoplasm of posterior wall of urinary bladder
interleukin-2	is a	immunotherapy drug used for	malignant neoplasm of posterior wall of urinary bladder
bladder-sparing approach	is an alternative to	radical cystectomy for	malignant neoplasm of posterior wall of urinary bladder
intravesical therapy	is a	treatment option for	malignant neoplasm of posterior wall of urinary bladder
BCG vaccine	is used in	intravesical therapy for	malignant neoplasm of posterior wall of urinary bladder
urothelial carcinoma in situ	is a	precursor lesion of	malignant neoplasm of posterior wall of urinary bladder
papillary urothelial carcinoma	is a	subtype of	malignant neoplasm of posterior wall of urinary bladder
multimodal approach	is often used for	treatment of malignant neoplasm of posterior wall of urinary bladder
urothelial cancer	is another term for	malignant neoplasm of posterior wall of urinary bladder
cystectomy with urinary diversion	is a	surgical option for	treatment of malignant neoplasm of posterior wall of urinary bladder
bladder-preserving chemotherapy	is used in combination with radiation therapy for	malignant neoplasm of posterior wall of urinary bladder
gemcitabine	is a	chemotherapy drug used for	malignant neoplasm of posterior wall of urinary bladder
squamous cell carcinoma	is a	rare type of	malignant neoplasm of posterior wall of urinary bladder
urothelial papilloma	is a	benign tumor that may mimic	malignant neoplasm of posterior wall of urinary bladder
microscopic hematuria	is an early sign of	malignant neoplasm of posterior wall of urinary bladder
ureteral reimplantation	is a	surgical procedure after	bladder reconstruction
biopsy	is a	procedure to obtain a tissue sample for diagnosis of	malignant neoplasm of posterior wall of urinary bladder
transurethral resection of bladder tumor (TURBT)	is a	surgical procedure to remove	malignant neoplasm of posterior wall of urinary bladder
metastasis	is the spread of	malignant neoplasm of posterior wall of urinary bladder to distant organs
urothelial carcinoma with variant histology	is a	subtype of	malignant neoplasm of posterior wall of urinary bladder
urothelial papilloma	may progress to	malignant neoplasm of posterior wall of urinary bladder
intravenous pyelogram (IVP)	is a	diagnostic test for	malignant neoplasm of posterior wall of urinary bladder
carcinoma in situ	is a	non-invasive form of	malignant neoplasm of posterior wall of urinary bladder
partial cystectomy	is a	surgical option for	treatment of malignant neoplasm of posterior wall of urinary bladder
neoadjuvant chemotherapy	is given before	surgery for malignant neoplasm of posterior wall of urinary bladder
cystoscopy with biopsy	is performed to confirm	malignant neoplasm of posterior wall of urinary bladder
retroperitoneal lymph node dissection	is performed to remove affected	lymph nodes in malignant neoplasm of posterior wall of urinary bladder
bladder-preserving approach	is an option for patients with	localized malignant neoplasm of posterior wall of urinary bladder
medical oncologist	specializes in	chemotherapy treatment for malignant neoplasm of posterior wall of urinary bladder
urothelial dysplasia	is a	precancerous condition that may progress to	malignant neoplasm of posterior wall of urinary bladder
intravesical bacillus Calmette-Guérin (BCG) therapy	is a	treatment option for	non-invasive malignant neoplasm of posterior wall of urinary bladder
urologist	is a	specialist who diagnoses and treats	malignant neoplasm of posterior wall of urinary bladder
palliative care	focuses on providing relief from symptoms and improving quality of life for	malignant neoplasm of posterior wall of urinary bladder patients
immunotherapy	is a	treatment option for	malignant neoplasm of posterior wall of urinary bladder
check-ups and follow-up appointments	are important for monitoring	malignant neoplasm of posterior wall of urinary bladder
urologist	may perform	urinary diversion surgery for	malignant neoplasm of posterior wall of urinary bladder
cigarette smoking	is a	major risk factor for	malignant neoplasm of posterior wall of urinary bladder
hematuria evaluation	is necessary to identify	underlying causes of hematuria in patients with	malignant neoplasm of posterior wall of urinary bladder
excision	is a	surgical procedure to remove	malignant neoplasm of posterior wall of urinary bladder
targeted therapy	is a	treatment option for	malignant neoplasm of posterior wall of urinary bladder
erlotinib	is a	targeted therapy drug used for	malignant neoplasm of posterior wall of urinary bladder
squamous cell carcinoma	may arise from	chronic irritation of the urinary bladder
family history of bladder cancer	is a	risk factor for	malignant neoplasm of posterior wall of urinary bladder
metastatic urothelial carcinoma	is a	advanced stage of	malignant neoplasm of posterior wall of urinary bladder
adjuvant chemotherapy	is given after	surgery for malignant neoplasm of posterior wall of urinary bladder
urothelial carcinoma	is the most common type of	malignant neoplasm of posterior wall of urinary bladder
intravesical chemotherapy	is a	local treatment option for	malignant neoplasm of posterior wall of urinary bladder
bladder-sparing treatment	may include	radiation therapy and chemotherapy for	malignant neoplasm of posterior wall of urinary bladder
complete blood count (CBC)	may show anemia in patients with	malignant neoplasm of posterior wall of urinary bladder
recurrence	is the return of	malignant neoplasm of posterior wall of urinary bladder after treatment
intravesical mitomycin C	is a	chemotherapy drug used for	non-invasive malignant neoplasm of posterior wall of urinary bladder
urothelial cancer	is the umbrella term for	malignant neoplasm of posterior wall of urinary bladder
neoplasm	is an abnormal growth of	cells in the posterior wall of urinary bladder
ultrasound	is a	diagnostic imaging technique for	malignant neoplasm of posterior wall of urinary bladder
prognosis	depends on the stage and grade of	malignant neoplasm of posterior wall of urinary bladder
CT scan	is used for	staging of malignant neoplasm of posterior wall of urinary bladder
bladder-preserving therapies	aim to maintain bladder function in	malignant neoplasm of posterior wall of urinary bladder patients
hematuria	is a common presenting symptom of	malignant neoplasm of posterior wall of urinary bladder
risk stratification	is important for determining appropriate treatment for	malignant neoplasm of posterior wall of urinary bladder
intravesical bacillus Calmette-Guérin (BCG) immunotherapy	is a	treatment option for	early-stage malignant neoplasm of posterior wall of urinary bladder
diagnostic imaging	helps in the evaluation of	malignant neoplasm of posterior wall of urinary bladder
urologist	may perform	bladder biopsy to diagnose	malignant neoplasm of posterior wall of urinary bladder
tumor markers	may be elevated in	malignant neoplasm of posterior wall of urinary bladder
Bohler angle	may be decreased in patients with	malignant neoplasm of posterior wall of urinary bladder
intravenous urography	is used to assess	urinary bladder function in patients with	malignant neoplasm of posterior wall of urinary bladder
tumor grade	is a	measure of aggressiveness of	malignant neoplasm of posterior wall of urinary bladder
neoadjuvant chemotherapy	is used to shrink tumors before	surgery for malignant neoplasm of posterior wall of urinary bladder
histopathology	provides	detailed information about the tumor type in	malignant neoplasm of posterior wall of urinary bladder
bladder preservation	is a	treatment goal for	localized malignant neoplasm of posterior wall of urinary bladder
intravesical chemotherapy	decreases the risk of	recurrence in malignant neoplasm of posterior wall of urinary bladder
radiation oncologist	specializes in	radiation therapy for malignant neoplasm of posterior wall of urinary bladder
cystoscopy	is used for	surveillance of malignant neoplasm of posterior wall of urinary bladder
intravenous pyelogram (IVP)	may show filling defects in patients with	malignant neoplasm of posterior wall of urinary bladder
tumor staging	helps in determining the extent of	malignant neoplasm of posterior wall of urinary bladder
partial cystectomy	preserves bladder function in selected cases of	malignant neoplasm of posterior wall of urinary bladder
local invasion	refers to the spread of	malignant neoplasm of posterior wall of urinary bladder into adjacent tissues
tumor size	is an important prognostic factor for	malignant neoplasm of posterior wall of urinary bladder
intravenous chemotherapy	is used for	advanced malignant neoplasm of posterior wall of urinary bladder
urothelial carcinoma with squamous differentiation	is a	subtype of	malignant neoplasm of posterior wall of urinary bladder
bladder-preserving approach	aims to maintain bladder function in	malignant neoplasm of posterior wall of urinary bladder patients
lymph node involvement	indicates advanced stage of	malignant neoplasm of posterior wall of urinary bladder
cystoscope	is a	specialized instrument used for	visualization of malignant neoplasm of posterior wall of urinary bladder
intravesical immunotherapy	stimulates the immune system to fight	non-invasive malignant neoplasm of posterior wall of urinary bladder
chemoradiation therapy	is a	combined treatment modality for	malignant neoplasm of posterior wall of urinary bladder
urine cytology	is a	diagnostic test for identification of	cancer cells in malignant neoplasm of posterior wall of urinary bladder
