other and unspecified prion disease of central nervous system	is a	neurodegenerative disorder
prion protein	is responsible for	other and unspecified prion disease of central nervous system
other and unspecified prion disease of central nervous system	can lead to	dementia
other and unspecified prion disease of central nervous system	is characterized by	cognitive decline
spongiform encephalopathy	is a	type of other and unspecified prion disease
protein misfolding	is associated with	other and unspecified prion disease of central nervous system
other and unspecified prion disease of central nervous system	has	no known cure
symptomatic treatment	is used for managing	other and unspecified prion disease of central nervous system
prion infection	can cause	other and unspecified prion disease of central nervous system
other and unspecified prion disease of central nervous system	may result in	death
genetic mutation	can increase the risk of	other and unspecified prion disease of central nervous system
neurological symptoms	are common in	other and unspecified prion disease of central nervous system
hereditary prion disease	is a	subtype of other and unspecified prion disease of central nervous system
fatal familial insomnia	is a	type of other and unspecified prion disease of central nervous system
other and unspecified prion disease of central nervous system	is associated with	abnormal protein deposits
protein misfolding	can lead to	other and unspecified prion disease of central nervous system
other and unspecified prion disease of central nervous system	is often misdiagnosed as	Alzheimer's disease
diagnostic tests	are used to detect	other and unspecified prion disease of central nervous system
electroencephalogram	can show abnormal brain activity in	other and unspecified prion disease of central nervous system
family history	is a	risk factor for other and unspecified prion disease of central nervous system
other and unspecified prion disease of central nervous system	can progress rapidly
other and unspecified prion disease of central nervous system	affects	the brain
other and unspecified prion disease of central nervous system	is more common in	older adults
psychiatric symptoms	can occur in	other and unspecified prion disease of central nervous system
neuropathological changes	are seen in	other and unspecified prion disease of central nervous system
other and unspecified prion disease of central nervous system	is a	rare condition
other and unspecified prion disease of central nervous system	is caused by	abnormal prion proteins
autoimmune encephalitis	can mimic the symptoms of	other and unspecified prion disease of central nervous system
neurodegeneration	is a hallmark of	other and unspecified prion disease of central nervous system
neurologist	specializes in treating	other and unspecified prion disease of central nervous system
other and unspecified prion disease of central nervous system	is a form of	encephalopathy
postmortem examination	is required for definite diagnosis of	other and unspecified prion disease of central nervous system
immunohistochemistry	is used to identify abnormal prion protein in	other and unspecified prion disease of central nervous system
neurological examination	is performed to assess	other and unspecified prion disease of central nervous system
sporadic prion disease	is a	type of other and unspecified prion disease of central nervous system
transmissible spongiform encephalopathy	is another term for	other and unspecified prion disease of central nervous system
other and unspecified prion disease of central nervous system	is progressive
chronic wasting disease	is a	related prion disease
other and unspecified prion disease of central nervous system	can be transmitted through	contaminated meat
other and unspecified prion disease of central nervous system	is not responsive to	standard treatments
other and unspecified prion disease of central nervous system	is a	fatal condition
neurological deterioration	is observed in	other and unspecified prion disease of central nervous system
other and unspecified prion disease of central nervous system	is transmitted through	prion-contaminated medical equipment
other and unspecified prion disease of central nervous system	is a	progressive illness
vCJD (variant Creutzfeldt-Jakob disease)	is a	form of other and unspecified prion disease of central nervous system
transmitted prion disease	is a	type of other and unspecified prion disease of central nervous system
prion disease surveillance	can help in early detection of	other and unspecified prion disease of central nervous system
asymptomatic carriers	can transmit	other and unspecified prion disease of central nervous system
other and unspecified prion disease of central nervous system	affects	the nervous system
genetic counseling	is recommended for individuals with	other and unspecified prion disease of central nervous system
creutzfeldt-jakob disease	is a	type of other and unspecified prion disease of central nervous system
severe headaches	can be a symptom of	other and unspecified prion disease of central nervous system
transmissible spongiform encephalopathies	are a group of	prion diseases
other and unspecified prion disease of central nervous system	has	no known cure
