abrasion or friction burn of finger(s)	is a	skin injury
abrasion or friction burn of finger(s)	can cause	pain
bandages	can be used for	abrasion or friction burn of finger(s)
cleaning	is important for	abrasion or friction burn of finger(s)
water	can be used for	cleaning
soap	can be used for	cleaning
infection	is a complication of	abrasion or friction burn of finger(s)
antibiotics	may be prescribed for	infection
healing	is the goal of	abrasion or friction burn of finger(s)
scarring	may occur as a result of	abrasion or friction burn of finger(s)
skin grafting	may be necessary for	severe abrasion or friction burn of finger(s)
fingertip amputation	can result from	severe abrasion or friction burn of finger(s)
tetanus shot	may be recommended for	contaminated abrasion or friction burn of finger(s)
debridement	is a procedure used for	severe or infected abrasion or friction burn of finger(s)
pain medication	may be prescribed for	abrasion or friction burn of finger(s)
redness and swelling	are common symptoms of	infected abrasion or friction burn of finger(s)
wound healing	can be delayed by	certain medical conditions like diabetes
patient education	is important for	preventing future abrasion or friction burn of finger(s)
protective gloves	can be used to prevent	future abrasion or friction burn of finger(s)
cool water	can be used to alleviate	pain from abrasion or friction burn of finger(s)
burn ointment	can be applied to	mild abrasion or friction burn of finger(s)
wound dressing	can help with	preventing infection of abrasion or friction burn of finger(s)
sterile technique	should be followed when cleaning	infected abrasion or friction burn of finger(s)
itching	is a common symptom of	healing abrasion or friction burn of finger(s)
cool compress	can be used to reduce	swelling of abrasion or friction burn of finger(s)
patient compliance	is important for	successful treatment of abrasion or friction burn of finger(s)
preventive measures	can reduce the risk of	future abrasion or friction burn of finger(s)
bleeding	may occur immediately after	abrasion or friction burn of finger(s)
topical antibiotic	can be used to prevent	infection of abrasion or friction burn of finger(s)
hydrogen peroxide	should not be used for	cleaning abrasion or friction burn of finger(s)
sterile saline solution	can be used for	cleaning infected abrasion or friction burn of finger(s)
pain management	is important for	patient comfort during treatment of abrasion or friction burn of finger(s)
signs of infection	such as red streaks or pus	require	immediate medical attention for abrasion or friction burn of finger(s)
wound care nurse	can provide specialized treatment for	severe or complicated abrasion or friction burn of finger(s)
skin infection	can develop from	untreated infected abrasion or friction burn of finger(s)
proper hand hygiene	is important for	preventing infection of abrasion or friction burn of finger(s)
smoking	can impair	wound healing of abrasion or friction burn of finger(s)
foreign objects	should be removed from	abrasion or friction burn of finger(s)
occupational therapy	may be needed for	rehabilitation after severe abrasion or friction burn of finger(s)
skin protection	should be used during	activities that may cause abrasion or friction burn of finger(s)
clean dressing	should be applied to	newly cleaned abrasion or friction burn of finger(s)
sterile tweezers	can be used to remove	foreign objects from abrasion or friction burn of finger(s)
pain assessment	is important for	determining appropriate pain management for abrasion or friction burn of finger(s)
rest	is important for	optimal healing of abrasion or friction burn of finger(s)
warm compress	can be used to increase	blood flow to promote healing of abrasion or friction burn of finger(s)
avoiding excessive moisture	can prevent	prolonged healing of abrasion or friction burn of finger(s)
secondary infection	can occur from	scratching or picking at healing abrasion or friction burn of finger(s)
steroid cream	can be used to reduce	inflammation of abrasion or friction burn of finger(s)
neosporin	is an over-the-counter antibiotic ointment used for	preventing infection of mild abrasion or friction burn of finger(s)
hand surgeon	may be consulted for	severe or complex abrasion or friction burn of finger(s)
wound closure	may be done using	stitches or glue for abrasion or friction burn of finger(s)
healing time	can vary depending on	severity of abrasion or friction burn of finger(s)
